111111111
1P0000O01
10OE00001
111111111
