111111111111111111111
100000000000000000001
1P000100000100C000001
100000000E00C00000001
100000010000000000001
10000CC00000C00100001
1000000C0000000000001
111111111111111111111
