11111111111111111111
1000000000000000O001
1P0001O00000100C0001
100000000E00CO000001
10000001O00000000001
100OCC0000O0C0010001
1000000C000000000001
11111111111111111111
