1111111111111111111111111111111
1000000000000C00000000100000001
1000P000000000000O0000000000001
1000000010000000000E00001000001
1000000000000100000000000000001
100001000C000O000000000O0000001
1000000C0000000E0000O0000000001
10000O000O000000000000000000001
10000000CC0000001110C0000100001
1000000000000000000000000000001
1111111111111111111111111111111
