111111111111111111111111111111111111
100000000000000000000000000000000001
100000E0000000000000000000C000000001
100000000000000000000000000000000001
100P000000000000000000000C0000000001
10000000E000000000000000000000000001
10000000000000000C000000000000000001
10000000000000C000000000C00000000001
100000000000000000000000000000000001
100000000000000000000000000000000001
111111111111111111111111111111111111