1111111111111111111
10P0000E00000000001
1111111111011111111

